{
  "width": 10,
  "height": 10,
  "start": {"x": 1, "y": 1},
  "exit": {"x": 8, "y": 8},
  "maze": [
    [1,1,1,1,1,1,1,1,1,1],
    [1,0,0,0,0,0,0,0,2,1],
    [1,1,1,1,1,1,1,1,0,1],
    [1,2,0,0,0,0,0,1,0,1],
    [1,1,1,1,1,1,0,1,0,1],
    [1,0,0,0,0,2,0,1,2,1],
    [1,0,1,1,1,1,1,1,0,1],
    [1,0,0,0,0,0,0,0,0,1],
    [1,1,1,1,1,1,1,1,3,1],
    [1,1,1,1,1,1,1,1,1,1]
  ],
  "patients": [
    {"x": 8, "y": 1},
    {"x": 1, "y": 3},
    {"x": 5, "y": 5},
    {"x": 8, "y": 5}
  ]
}